15 15
4 -1 0 6 -1 7 2 3 3 8 5 5 5 9 9 
3 5 -1 0 -1 6 6 2 -1 4 2 3 2 6 1 
8 4 2 0 4 -1 2 0 0 8 1 4 7 2 7 
8 6 8 8 5 9 3 8 9 9 1 8 4 2 0 
1 5 1 5 3 0 4 3 1 -1 0 -1 8 1 7 
6 -1 4 -1 9 1 5 6 1 3 -1 9 7 8 0 
7 9 1 -1 -1 1 -1 -1 8 2 5 1 3 3 1 
6 9 5 2 6 9 4 1 5 8 -1 8 3 -1 3 
0 5 3 8 8 6 3 7 5 4 -1 6 -1 8 1 
-1 2 -1 -1 1 1 3 7 7 0 4 7 6 6 9 
2 2 -1 3 2 7 9 7 7 3 1 3 8 -1 6 
5 0 1 -1 2 7 5 7 5 6 0 0 2 0 4 
5 1 5 7 9 0 4 7 6 6 3 8 1 8 1 
8 9 7 6 5 0 3 3 3 3 3 4 4 5 9 
6 9 7 4 1 6 1 3 6 3 5 6 1 8 8 
0 5 13 12
