20 23
1 4 4 3 -1 4 5 6 7 8 1 3 1 2 3 7 9 3 6 5 5 1 4 
7 3 5 4 3 2 1 3 2 3 8 5 6 9 6 -1 8 9 1 9 4 -1 6 
-1 7 6 7 4 6 8 2 7 -1 2 -1 8 6 5 1 4 6 5 9 4 3 -1 
7 1 -1 1 9 8 6 7 9 4 9 4 8 1 4 6 -1 3 2 3 -1 6 6 
2 9 6 6 -1 5 -1 6 6 7 5 3 5 -1 5 4 8 9 7 9 6 5 2 
1 6 8 9 8 5 3 7 5 4 8 3 4 8 1 6 8 3 6 1 1 2 2 
4 6 -1 -1 4 5 8 3 9 5 9 7 4 6 5 3 1 4 1 8 9 4 1 
5 7 -1 1 -1 3 9 7 8 -1 1 9 5 3 5 -1 1 5 3 9 9 2 5 
6 -1 3 5 6 2 9 7 1 9 1 5 -1 1 1 7 -1 8 9 1 6 -1 6 
3 4 -1 7 2 4 6 2 8 8 3 4 6 5 -1 9 8 5 -1 9 9 4 4 
-1 1 -1 8 6 2 3 7 2 -1 1 2 8 -1 7 9 9 5 1 8 8 -1 4 
9 -1 5 8 6 5 6 2 8 6 -1 1 8 7 6 1 5 3 -1 6 3 8 -1 
-1 7 6 4 -1 4 -1 2 2 5 6 5 2 6 7 6 3 2 7 6 8 8 8 
8 6 7 -1 -1 6 -1 7 9 7 5 9 4 3 6 7 4 6 3 3 9 2 1 
3 3 2 5 4 8 1 7 4 7 3 5 4 2 8 4 8 9 5 1 3 9 -1 
6 2 6 8 2 3 2 6 4 4 9 9 -1 9 8 8 5 4 -1 9 3 -1 6 
3 7 7 5 4 2 1 6 8 6 7 3 1 2 1 6 2 9 4 6 4 -1 7 
6 8 1 3 4 9 3 4 6 2 5 6 3 1 9 7 3 2 5 3 3 4 7 
7 7 7 9 6 -1 4 4 4 4 2 9 -1 6 9 8 5 5 3 6 8 9 1 
-1 8 2 2 8 7 2 6 7 7 5 8 9 5 8 4 5 5 6 4 -1 6 8 
1 10 18 11